{
	"map":[
		{
			"id":0,
			"name":"Test Map",
			"tilesetID":1,
			"tile":[
				[2,2,2,2,2,2,2,2,2,2,2,2,2,2,2,2,2,2,2,2,2,2,2,2],
				[2,1,1,1,1,1,1,1,1,1,1,1,1,1,1,1,1,1,1,1,1,1,1,2],
				[2,1,1,1,1,1,1,1,1,1,1,1,1,1,1,1,1,1,1,1,2,1,1,2],
				[2,1,1,1,1,1,1,1,1,1,1,1,1,1,1,1,1,1,1,1,2,1,1,2],
				[2,1,1,1,1,1,3,1,1,5,1,1,1,1,1,1,1,2,2,2,2,1,1,2],
				[2,1,1,1,1,1,1,1,1,1,1,1,1,1,2,1,1,1,1,1,1,1,1,2],
				[2,1,2,1,1,1,6,1,1,4,1,1,1,1,1,1,1,1,1,1,1,1,1,2],
				[2,1,2,1,1,1,1,1,1,1,1,1,1,1,1,1,1,1,1,1,1,1,1,2],
				[2,1,2,1,1,1,2,2,2,1,1,1,1,1,1,1,1,1,1,1,1,1,1,2],
				[2,1,2,1,1,1,1,1,1,1,1,1,1,1,1,1,1,1,1,1,1,1,1,2],
				[2,1,1,1,1,1,1,1,1,1,1,1,1,1,1,1,1,1,1,1,1,1,1,2],
				[2,1,1,1,1,1,1,1,1,1,1,1,1,1,1,1,1,1,1,1,1,1,1,2],
				[2,1,1,1,1,1,1,1,1,1,1,1,1,1,1,1,1,1,1,1,2,2,1,2],
				[2,1,1,1,1,1,1,1,1,1,1,2,1,1,1,2,1,1,1,1,2,1,1,2],
				[2,1,1,1,2,1,1,1,1,1,1,2,1,1,1,1,1,1,1,1,1,1,1,2],
				[2,1,1,1,1,1,1,1,1,1,1,2,1,1,1,1,1,1,1,1,1,1,1,2],
				[2,1,1,1,1,1,1,1,1,1,1,1,1,1,1,1,1,1,1,1,1,1,1,2],
				[2,2,2,2,2,2,2,2,2,2,2,2,2,2,2,2,2,2,2,2,2,2,2,2]
			]
		},
		{	"id":1,
			"name":"Level 1",
			"tilesetID":1,
			"tile":[
				[2,2,2,2,2,2,2,2,2,2,2,2,2,2,2,2,2,2,2],
				[2,1,1,1,1,1,1,1,1,2,1,1,1,1,1,1,1,1,2],
				[2,1,2,2,1,2,2,2,1,2,1,2,2,2,1,2,2,1,2],
				[2,1,1,1,1,1,1,1,1,1,1,1,1,1,1,1,1,1,2],
				[2,1,2,2,1,2,1,2,2,2,2,2,1,2,1,2,2,1,2],
				[2,1,1,1,1,2,1,1,1,2,1,1,1,2,1,1,1,1,2],
				[2,2,2,2,1,2,2,2,1,2,1,2,2,2,1,2,2,2,2],
				[2,0,0,2,1,2,1,1,1,8,1,1,1,2,1,2,0,0,2],
				[2,2,2,2,1,2,1,2,2,0,2,2,1,2,1,2,2,2,2],
				[2,1,1,1,1,1,1,2,0,0,0,2,1,1,1,1,1,1,2],
				[2,2,2,2,1,2,1,2,2,2,2,2,1,2,1,2,2,2,2],
				[2,0,0,2,1,2,1,1,1,1,1,1,1,2,1,2,0,0,2],
				[2,2,2,2,1,2,1,2,2,2,2,2,1,2,1,2,2,2,2],
				[2,1,1,1,1,1,1,1,1,2,1,1,1,1,1,1,1,1,2],
				[2,1,2,2,1,2,2,2,1,2,1,2,2,2,1,2,2,1,2],
				[2,1,1,2,1,1,1,1,1,7,1,1,1,1,1,2,1,1,2],
				[2,2,1,2,1,2,1,2,2,2,2,2,1,1,1,2,1,2,2],
				[2,1,1,1,1,2,1,1,1,2,1,1,1,2,1,1,1,1,2],
				[2,1,2,2,2,2,2,2,1,2,1,2,2,2,2,2,2,1,2],
				[2,1,1,1,1,1,1,1,1,1,1,1,1,1,1,1,1,1,2],
				[2,2,2,2,2,2,2,2,2,2,2,2,2,2,2,2,2,2,2]
			]
		}
	]
}
