{
	"map":[
		{
			"id":0,
			"name":"Test Map",
			"tilesetID":1,
			"tile":[
				[2,2,2,2,2,2,2,2,2,2,2,2,2,2,2,2,2,2,2,2,2,2,2,2],
				[2,1,1,1,1,1,1,1,1,1,1,1,1,1,1,1,1,1,1,1,1,1,1,2],
				[2,1,1,1,1,1,1,1,1,1,1,1,1,1,1,1,1,1,1,1,2,1,1,2],
				[2,1,1,1,1,1,1,1,1,1,1,1,1,1,1,1,1,1,1,1,2,1,1,2],
				[2,1,1,1,1,1,3,1,1,5,1,1,1,1,1,1,1,2,2,2,2,1,1,2],
				[2,1,1,1,1,1,1,1,1,1,1,1,1,1,2,1,1,1,1,1,1,1,1,2],
				[2,1,2,1,1,1,6,1,1,4,1,1,1,1,1,1,1,1,1,1,1,1,1,2],
				[2,1,2,1,1,1,1,1,1,1,1,1,1,1,1,1,1,1,1,1,1,1,1,2],
				[2,1,2,1,1,1,2,2,2,1,1,1,1,1,1,1,1,1,1,1,1,1,1,2],
				[2,1,2,1,1,1,1,1,1,1,1,1,1,1,1,1,1,1,1,1,1,1,1,2],
				[2,1,1,1,1,1,1,1,1,1,1,1,1,1,1,1,1,1,1,1,1,1,1,2],
				[2,1,1,1,1,1,1,1,1,1,1,1,1,1,1,1,1,1,1,1,1,1,1,2],
				[2,1,1,1,1,1,1,1,1,1,1,1,1,1,1,1,1,1,1,1,2,2,1,2],
				[2,1,1,1,1,1,1,1,1,1,1,2,1,1,1,2,1,1,1,1,2,1,1,2],
				[2,1,1,1,2,1,1,1,1,1,1,2,1,1,1,1,1,1,1,1,1,1,1,2],
				[2,1,1,1,1,1,1,1,1,1,1,2,1,1,1,1,1,1,1,1,1,1,1,2],
				[2,1,1,1,1,1,1,1,1,1,1,1,1,1,1,1,1,1,1,1,1,1,1,2],
				[2,2,2,2,2,2,2,2,2,2,2,2,2,2,2,2,2,2,2,2,2,2,2,2]
			]
		},
		{	"id":1,
			"name":"Level 1",
			"tilesetID":1,
			"tile":[
				[2, 2, 2, 2, 2, 2, 2, 2, 2, 2, 2, 2, 2, 2, 2, 2, 2, 2, 2],
				[2, 2, 2, 2, 2, 2, 2, 2, 2, 2, 2, 2, 2, 2, 2, 2, 2, 2, 2],
				[2,13,12,12,12,12,12,12,12, 2,12,12,12,12,12,12,12,13, 2],
				[2,12, 2, 2,12, 2, 2, 2,12, 2,12, 2, 2, 2,12, 2, 2,12, 2],
				[2,12,12,12,12,12,12,12,12,12,12,12,12,12,12,12,12,12, 2],
				[2,12, 2, 2,12, 2,12, 2, 2, 2, 2, 2,12, 2,12, 2, 2,12, 2],
				[2,12,12,12,12, 2,12,12,12, 2,12,12,12, 2,12,12,12,12, 2],
				[2, 2, 2, 2,12, 2, 2, 2,12, 2,12, 2, 2, 2,12, 2, 2, 2, 2],
				[2, 0, 0, 2,12, 2,12,12,12, 8,12,12,12, 2,12, 2, 0, 0, 2],
				[2, 2, 2, 2,12, 2,12, 2, 2, 1, 2, 2,12, 2,12, 2, 2, 2, 2],
				[2,12,12,12,12,12,12, 2,10, 1, 1, 2,12,12,12,12,12,12, 2],
				[2, 2, 2, 2,12, 2,12, 2, 2, 2, 2, 2,12, 2,12, 2, 2, 2, 2],
				[2, 0, 0, 2,12, 2,12,12,12,12,12,12,12, 2,12, 2, 0, 0, 2],
				[2, 2, 2, 2,12, 2,12, 2, 2, 2, 2, 2,12, 2,12, 2, 2, 2, 2],
				[2,12,12,12,12,12,12,12,12, 2,12,12,12,12,12,12,12,12, 2],
				[2,12, 2, 2,12, 2, 2, 2,12, 2,12, 2, 2, 2,12, 2, 2,12, 2],
				[2,12,12, 2,12,12,12,12,12, 7,12,12,12,12,12, 2,12,12, 2],
				[2, 2,12, 2,12, 2,12, 2, 2, 2, 2, 2,12, 2,12, 2,12, 2, 2],
				[2,12,12,12,12, 2,12,12,12, 2,12,12,12, 2,12,12,12,12, 2],
				[2,12, 2, 2, 2, 2, 2, 2,12, 2,12, 2, 2, 2, 2, 2, 2,12, 2],
				[2,13,12,12,12,12,12,12,12,12,12,12,12,12,12,12,12,13, 2],
				[2, 2, 2, 2, 2, 2, 2, 2, 2, 2, 2, 2, 2, 2, 2, 2, 2, 2, 2]
			]
		}
	]
}
